id	displayName
SOF_LDV	SOF/LDV
SOF_DCV	SOF/DCV
SOF_VEL	SOF/VEL
SOF_SIM	SOF/SIM
SOF_mono	SOF mono
SOF_RBV	SOF/RBV
SOF_PEG_RBV	SOF/PEG/RBV
SOF_VEL_VOX	SOF/VEL/VOX
PIB_PTV_r	PIB/PTV/r
GLE_PIB	GLE/PIB
EBR_GZR_RBV	EBR/GZR/RBV
EBR_GZR	EBR/GZR
EBR_GZR_SOF	EBR/GZR/SOF
SOF_LDV_RBV	SOF/LDV/RBV
DCV_ASV	DCV/ASV
DCV_ASV_PR	DCV/ASV/PR
DCV_mono	DCV mono
DCV_PR	DCV/PR
DCV_SIM_RBV	DCV/SIM/RBV
DCV_SIM	DCV/SIM
SOF_DCV_SIM_RBV	SOF/DCV/SIM/RBV
DCV_ASV_BCV	DCV/ASV/BCV
SOF_VEL_RBV	SOF/VEL/RBV
SOF_DCV_RBV	SOF/DCV/RBV
DCV_ASV_RBV	DCV/ASV/RBV
EBR_GZR_SOF_RBV	EBR/GZR/SOF/RBV
GZR_RBV	GZR/RBV
IFN_RBV_GZR	IFN/RBV/GZR
PTV_r_OBV_DSV	PTV/r/OBV/DSV
PTV_r_OBV_DSV_RBV	PTV/r/OBV/DSV/RBV
PTV_r_OBV_RBV	PTV/r/OBV/RBV
PTV_r_OBV	PTV/r/OBV
PIB_PTV_r_RBV	PIB/PTV/r/RBV
